11111111
101C00P1
10111001
1000C011
10111001
100E1011
11111111
