111111111
100000001
100E00111
100P00111
111111111
