111111111
100000001
100P00111
100C00111
111111111
