11111111
1000C001
1E000011
100001P1
11111111
