111111111
100E00001
100000001
111111111
1000000P1
100000001
10C000001
111111111
