111111111
100C00001
100000001
111111111
1000000P1
100000001
10E000001
111111111
