111111111
100000001
100E00111
100C00111
111111111
