1111111
1000001
1000001
1000001
1000001
111111111
