1111111
1000001
1111111
1000001
10EPC11
1111111
