1111111111
110000E001
1000110001
1C00100001
11000000C1
1111000001
1110001C01
10P0001111
1111111111